........................................
........................................
........................................
........................................
........................................
........................................
........................................
........................................
........................................
........................................
........................................
........................................
........................................
S..M........M....P.....M.........M.....X
########################################
########################################
########################################
########################################
########################################
########################################
########################################
########################################
########################################
########################################